Chuvash	Chv	NEEur	3
Abkhasian	Abk	Caucasus	1
Adygei	Ady	Caucasus	1
Albanian	Alb	SEur	4
Armenian	Arm	Caucasus	1
Assyrian	Asr	NEast	2
Balkar	Blk	Caucasus	1
Basque	Bsq	SEur	4
BedouinA	BeA	NEast	2
BedouinB	BeB	NEast	2
Belarusian	Bel	NEEur	3
Bulgarian	Bul	SEur	4
Canary_Islander	CIl	SEur	4
Chechen	Che	Caucasus	1
Croatian	Cro	SEur	4
Cypriot	Cyp	SEur	4
Czech	Cze	NEur	5
Druze	Dru	NEast	2
English	Eng	NEur	5
Estonian	Est	NEEur	3
Finnish	Fin	NEEur	3
French	Fre	NEur	5
Georgian	Geo	Caucasus	1
German	Ger	NEur	5
Greek	Grk	SEur	4
Hungarian	Hun	NEEur	3
Icelandic	Ice	NEur	5
Iranian	Irn	NEast	2
Irish	Irl	NEur	5
Irish_Ulster	Iru	NEur	5
Italian_North	ItN	SEur	4
Italian_South	ItS	SEur	4
Jew_Ashkenazi	JAs	NEast	2
Jew_Georgian	JGe	NEast	2
Jew_Iranian	JIr	NEast	2
Jew_Iraqi	JIq	NEast	2
Jew_Libyan	JLi	NEast	2
Jew_Moroccan	JMo	NEast	2
Jew_Tunisian	JTn	NEast	2
Jew_Turkish	JTr	NEast	2
Jew_Yemenite	JYm	NEast	2
Jordanian	Jor	NEast	2
Kumyk	Kum	Caucasus	1
Lebanese_Christian	LeC	NEast	2
Lebanese	Leb	NEast	2
Lebanese_Muslim	LeM	NEast	2
Lezgin	Lez	Caucasus	1
Lithuanian	Lth	NEEur	3
Maltese	Mlt	SEur	4
Mordovian	Mor	NEEur	3
North_Ossetian	NOs	Caucasus	1
Norwegian	Nrw	NEur	5
Orcadian	Orc	NEur	5
Palestinian	Pal	NEast	2
Polish	Pol	NEEur	3
Romanian	Rom	SEur	4
Russian	Rus	NEEur	3
Sardinian	Srd	SEur	4
Saudi	SAr	NEast	2
Scottish	Sct	NEur	5
Shetlandic	Sht	NEur	5
Sicilian	Sic	SEur	4
Sorb	Sor	NEEur	3
Spanish_North	SpN	SEur	4
Spanish	Spa	SEur	4
Syrian	Syr	NEast	2
Turkish	Tur	NEast	2
Ukrainian	Ukr	NEEur	3
